border_size=1
usage=map

Gs^Fp       , Gs^Fp       , Gs^Fp       , Gs^Fp       , Gs^Fp       , Gs^Fp       , Gs^Fp       , Gs^Fp       , Gs^Fp       , Gs^Fp       , Gs^Fp       , Gs^Fp       , Gs^Fp       , Gs^Fp       , Gs^Fp       , Gs^Fp       , Gs^Fp       , Gs^Fp       , Gs^Fp       
Gs^Fp       , Gs^Fp       , Gs^Fp       , Gs^Fp       , Gs^Fp       , Gs^Fp       , Gs^Fp       , Gs^Fp       , Gs^Fp       , Gs^Fp       , Gs^Fp       , Gs^Fp       , Gs^Fp       , Gs^Fp       , Gs^Fp       , Gs^Fp       , Gs^Vht      , Gs^Fp       , Gs^Fp       
Gs^Fp       , Gs^Fp       , Hh          , Hh^Fp       , Gs^Fp       , Gs^Fp       , Gs^Fp       , Gs^Fp       , Ce          , Ke          , Ce          , Gs^Fp       , Gs^Fp       , Gs^Fp       , Gs^Fp       , Gs^Fp       , Gs^Fp       , Gs^Fp       , Gs^Fp       
Gs^Fp       , Gs^Fp       , Gs^Fp       , Gs^Fp       , Gs^Fp       , Gs^Fp       , Ce          , Ce          , Gg          , Gg^Ve       , Gg^Wm       , Ce          , Ce          , Gs^Fp       , Gs^Fp       , Gs^Fp       , Gs^Fp       , Gs^Fp       , Gs^Fp       
Gs^Fp       , Gs^Fp       , Gs^Fp       , Gs^Fp       , Ce          , Ce          , Re^Gvs      , Re^Gvs      , Gs^Efm         , Gg          , Gs^Efm         , Re^Gvs      , Re^Gvs      , Ce          , Ce          , Gs^Fp       , Gs^Fp       , Gs^Fp       , Gs^Fp       
Gs^Fp       , Gs^Fp       , Gs^Fp       , Ke          , Gg^Ve       , Gg^Wm       , Gs^Efm         , Gs^Efm         , Ch          , Ch          , Ch          , Gs^Efm         , Gs^Efm         , Gg          , Gg^Ve       , Ke          , Gs^Fp       , Gs^Fp       , Gs^Fds      
Re          , Gs^Fp       , Gs^Fp       , Ce          , Gg          , Gg          , Ch          , Ch          , Cv          , Kv          , Cv          , Ch          , Ch          , Gg          , Gg^Wm       , Ce          , Gs^Fp       , Gs^Fp       , Gs^Fp       
Gs^Fp       , Re          , Re          , Ce          , Re^Gvs      , Gs^Efm         , Ch          , Kv          , Cv          , Cv          , Cv          , Kv          , Ch          , Gs^Efm         , Re^Gvs      , 3 Ce        , Gs^Fp       , Gs^Fp       , Gs^Fp       
Gs^Fp       , Gs^Fp       , Gs^Fp       , Ce          , Re^Gvs      , Gs^Efm         , Ch          , Cv          , Cv          , 4 Kv        , Cv          , Cv          , Ch          , Gs^Efm         , Re^Gvs      , 2 Ce        , Gs^Fp       , Gs^Fp       , Gs^Fp       
Gs^Fp       , Gs^Fp       , Gs^Fp       , Ce          , Gg^Wm       , Gs^Efm         , Ch          , Kv          , Cv          , Cv          , Cv          , Kv          , Ch          , Gs^Efm         , Gg          , 1 Ce        , Gs^Fp       , Gs^Fp       , Gs^Fp       
Gs^Fp       , Gs^Fp       , Gs^Fp       , Ce          , Gg^Ve       , Gg          , Gs^Efm         , Ch          , Ch          , Kv          , Ch          , Ch          , Gs^Efm         , Gg          , Gg^Ve       , Ce          , Gs^Fp       , Gs^Fp       , Gs^Fp       
Gs^Fp       , Gs^Fp       , Gs^Fp       , Ke          , Ce          , Gg          , Re^Gvs      , Gs^Efm         , Gs^Efm         , Ch          , Gs^Efm         , Gs^Efm         , Re^Gvs      , Gg^Wm       , Ce          , Ke          , Gs^Fp       , Gs^Fp       , Gs^Fp       
Gs^Fp       , Gs^Fp       , Gs^Fp       , Gs^Fp       , Gs^Fp       , Ce          , Ce          , Re^Gvs      , Gg^Wm       , Gg          , Gg          , Re^Gvs      , Ce          , Ce          , Gs^Fp       , Gs^Fp       , Gs^Fp       , Gs^Fp       , Re          
Gs^Fp       , Gs^Fp       , Gs^Fp       , Gs^Fp       , Gs^Fp       , Gs^Fp       , Gs^Fp       , Ce          , Ce          , Gg^Ve       , Ce          , Ce          , Gs^Fp       , Gs^Fp       , Gs^Fp       , Gs^Fp       , Re          , Re          , Gg          
Gs^Fp       , Gs^Fp       , Gs          , Gs          , Gs^Fp       , Gs^Fp       , Gs^Fp       , Gs^Fp       , Gs^Fp       , Ke          , Gs^Fp       , Re          , Re          , Gs^Fp       , Re          , Re          , Gs^Efm         , Gg          , Gg          
Gs^Fp       , Gs          , Gs          , Gs          , Gs          , Gs^Fms      , Gs^Fms      , Gs^Fp       , Gs^Fp       , Gs^Fp       , Gs^Fp       , Re          , Gs^Fp       , Re          , Gs^Fp       , Gs^Fp       , Gs^Fp       , Gg^Ve       , Gs^Fp       
Gs^Fp       , Gs^Fp       , Gs^Fp       , Gs          , Gs^Fms      , Gs^Fms      , Gs^Fp       , Gs^Fms      , Gs^Fms      , Gs^Fp       , Re          , Re          , Gs^Fp       , Gs^Fp       , Gs^Fp       , Gs^Fp       , Gs^Fp       , Gs^Fp       , Gs^Fp       
