border_size=1
usage=map

Aa^Fpa      , Aa^Fpa      , Aa^Fpa      , Aa^Fpa      , Aa^Fpa      , Aa^Fpa      , Aa^Fpa      , Aa^Fpa      , Aa^Fpa      , Aa^Fpa      , Aa^Fpa      , Aa^Fpa      , Aa^Fpa      , Aa^Fpa      , Aa^Fpa      , Aa^Fpa      , Aa^Fpa      , Aa^Fpa      , Aa^Fpa      , Aa^Fpa      , Aa^Fpa      , Aa^Fpa      , Aa^Fpa      , Aa^Fpa      , Aa^Fpa      , Aa^Fpa      , Aa^Fpa      , Aa^Fpa      , Aa^Fpa      , Aa^Fpa      , Aa^Fpa      , Aa^Fpa      , Aa^Fpa      , Aa^Fpa      , Aa^Fpa      , Aa^Fpa      , Aa^Fpa      
Ha          , Aa^Fpa      , Aa^Fpa      , Aa^Fpa      , Aa^Fpa      , Aa^Fpa      , Ha^Fpa      , Ha^Fpa      , Ha          , Aa^Fpa      , Ha^Vhha     , Aa^Fpa      , Ha^Fpa      , Ha^Fpa      , Ha          , Ha          , Ha          , Ha          , Ha          , Aa^Fpa      , Aa^Fpa      , Aa^Fpa      , Aa^Fpa      , Aa^Fpa      , Aa^Fpa      , Aa^Fpa      , Aa^Fpa      , Aa^Fpa      , Aa^Fpa      , Aa^Fpa      , Aa^Fpa      , Aa^Fpa      , Aa^Fpa      , Aa^Fpa      , Aa^Fpa      , Aa^Fpa      , Aa^Fpa      
Mm          , Aa^Vha      , Ha          , Ha          , Ha          , Aa^Fpa      , Aa^Fpa      , Ha          , Ms          , Mm          , Ha          , Ha          , Ha^Fpa      , Ha          , Ch          , Ch          , Ch          , Ha          , Ha          , Aa^Vha      , Aa^Fpa      , Aa^Fpa      , Aa^Fpa      , Aa^Fpa      , Aa^Fpa      , Aa^Fpa      , Ha          , Ha^Fpa      , Aa^Fpa      , Aa^Fpa      , Aa^Vea      , Ha          , Ha          , Ha          , Ha          , Ha          , Ha          
Mm          , Mm          , Mm          , Mm          , Ha^Fpa      , Aa^Fpa      , Ms          , Ms          , Ms          , Mm          , Mm          , Ha^Fpa      , Ha          , Ha          , Ch          , 5 Kh        , Ch          , Ch          , Ha          , Ha          , Aa^Fpa      , Aa^Fpa      , Aa^Fpa      , Aa^Fpa      , Ha          , Aa^Fpa      , Ha          , Aa^Fpa      , Aa^Fpa      , Aa^Fpa      , Ha^Fpa      , Mm          , Ms          , Mm          , Mm          , Mm          , Mm          
Ha          , Ha          , Ha          , Ha          , Ha^Fpa      , Aa^Fpa      , Ha          , Ha          , Mm          , Mm          , Mm          , Ms          , Ms          , Ha          , Ha          , Ch          , Ha          , Ha          , Mm          , Ha          , Ha          , Ha^Fpa      , Ha^Fpa      , Ha          , Ms          , Ha^Vhha     , Mm          , Ha          , Ha          , Aa^Fpa      , Ms          , Ms          , Ha          , Ha          , Ms          , Ms          , Mm          
Ha          , Mm          , Mm          , Mm          , Ha^Fpa      , Ha^Fpa      , Mm          , Mm          , Mm          , Mm          , Mm          , Ms          , Mm          , Mm          , Ha          , Ha          , Mm          , Mm          , Mm          , Ms          , Ms          , Ha          , Ha^Fpa      , Ms          , Ms          , Mm          , Ha          , Mm          , Ha          , Mm          , Ha          , Ha^Vhha     , Mm          , Ha          , Mm          , Ms          , Mm          
Mm          , Ha          , Mm          , Mm          , Ha          , Ha          , Ha          , Mm          , Mm^Vhh      , Mm          , Mm          , Mm          , Mm          , Mm          , Ha          , Mm          , Mm          , Mm          , Mm          , Mm^Vhh      , Mm          , Ms          , Mm          , Ha^Fpa      , Ha          , Ha          , Mm          , Ha          , Mm          , Ha          , Mm          , Mm          , Ch          , Mm          , Mm          , Ms          , Mm          
Ha          , Aa^Vha      , Ha          , Ha          , Ha          , Mm          , Mm          , Ms          , Ms          , Mm          , Mm          , Mm          , Mm          , Mm          , Ha          , Ha          , Mm^Xm       , Mm          , Ms          , Mm          , Mm          , Mm          , Mm          , Ha^Fpa      , Mm          , Mm          , Ha          , Mm          , Ha          , Ha          , Ch          , Ch          , 6 Kh        , Ch          , Mm          , Ms          , Mm          
Mm          , Ha          , Mm          , Ha          , Mm          , Ha          , Ha          , Ha          , Mm          , Ms          , Mm          , Mm          , Mm          , Mm          , Ha          , Mm^Xm       , Mm^Xm       , Mm^Xm       , Mm          , Ms          , Mm          , Mm          , Ha^Fpa      , Ha^Fpa      , Hh          , Ha          , Mm          , Ha          , Mm          , Mm          , Mm          , Ch          , Ch          , Ch          , Mm          , Mm          , Mm          
Mm          , Mm          , Ha          , Ms          , Ha          , Ha          , Ha          , Ha          , Mm          , Mm          , Mm          , Mm          , Mm          , Ha          , Mm          , Ha          , Mm          , Mm          , Mm          , Mm          , Mm^Vhh      , Mm          , Ha^Fpa      , Ha^Fpa      , Ha^Vhha     , Mm          , Mm          , Mm          , Ha          , Ha^Vhha     , Ha          , Mm          , Mm          , Mm          , Hh          , Mm          , Mm          
Mm          , Mm          , Ha          , Ha          , Mm          , Mm          , Mm          , Mm          , Mm          , Ha          , Ha          , Mm          , Ha          , Mm          , Mm          , Ha          , Hh          , Mm^Vhh      , Mm          , Mm          , Mm          , Mm          , Hh          , Mm          , Ha          , Ha          , Mm          , Ha          , Ha          , Ha          , Ha          , Mm          , Hh^Fdf      , Mm          , Ha          , Ha^Vhha     , Mm          
Mm          , Mm          , Mm^Vhh      , Mm          , Mm          , Mm          , Mm          , Mm          , Mm          , Hh          , Mm          , Mm          , Mm          , Mm          , Mm          , Mm          , Ha          , Mm          , Mm          , Mm          , Hh          , Hh^Fdw      , Mm          , Mm          , Mm          , Mm          , Mm          , Mm          , Mm          , Mm          , Mm          , Mm          , Hh          , Hh^Fdf      , Mm          , Mm          , Mm          
Mm          , Mm          , Mm          , Mm          , Mm          , Mm          , Mm          , Mm          , Mm          , Mm          , Mm          , Hh^Vhh      , Hh          , Mm          , Mm^Xm       , Mm          , Mm          , Ha          , Ha          , Hh          , Hh^Fdw      , Mm          , Mm          , Mm^Vhh      , Mm          , Ha          , Mm          , Ha          , Mm          , Hh^Fdf      , Hh^Fdf      , Mm          , Rd          , Mm          , Mm          , Mm          , Mm          
Hh^Fdf      , Hh          , Hh          , Hh          , Hh^Fdw      , Hh          , Hh          , Hh          , Hh          , Hh          , Mm          , Mm          , Mm          , Mm^Xm       , Mm^Xm       , Mm^Xm       , Mm          , Mm          , Mm          , Mm          , Hh          , Mm          , Mm          , Mm          , Mm          , Mm          , Mm          , Mm          , Hh^Vhh      , Hh          , Hh^Fdf      , Hh^Fdf      , Rd          , Hh^Vhh      , Hh^Fmf      , Hh^Fdf      , Hh^Fdf      
Hh^Fdf      , Hh^Fdf      , Mm          , Mm          , Mm          , Hh^Fdw      , Mm          , Hh          , Mm          , Mm          , Mm          , Mm          , Mm          , Mm^Xm       , Mm          , Mm^Xm       , Mm          , Mm          , Mm          , Mm          , Hh^Fdf      , Mm          , Xu          , Hh          , Xu          , Mm          , Hh          , Mm          , Mm          , Hh          , Hh^Fdf      , Hh^Fdf      , Rd          , Hh          , Hh^Fmf      , Hh^Fdf      , Hh          
Hh^Fdf      , Hh^Fdf      , Hh          , Mm          , Mm          , Mm          , Mm          , Mm          , Hh          , Mm          , Mm          , Mm          , Mm^Vhh      , Mm          , Mm          , Mm          , Mm          , Mm          , Mm          , Mm          , Rd          , Xu          , Uu          , Xu          , Uu^Vud      , Xu          , Xu          , Hh          , Mm          , Mm          , Hh^Fdf      , Hh^Fdf      , Rd          , Hh^Fdf      , Hh          , Hh^Fmf      , Hh          
Hh          , Hh          , Mm          , Mm^Vhh      , Mm          , Mm          , Mm          , Mm          , Ch          , Ch          , 3 Kh        , Mm          , Rd          , Rd          , Rd          , Hh          , Mm          , Mm          , Ch          , Rd          , Mm          , Rd          , Xu          , Uu          , Uu          , Uh          , Xu          , Xu          , Xu          , Hh          , Hh^Fdf      , Hh          , Rd          , Hh^Fdf      , Gg          , Hh^Fmf      , Gg          
Mm          , Hh          , Hh          , Mm          , Mm          , Mm          , Ch          , Ch          , Ch          , 1 Kh        , 2 Kh        , Ch          , Mm          , Hh          , Mm          , Rd          , Rd          , Ch          , 4 Kh        , Ch          , Mm          , Hh          , Gg^Vh       , Xu          , Uu^Vu       , Uu          , Uu          , Rd          , Rd          , Hh          , Rd          , Rd          , Gg^Vh       , Gg          , Gs^Fp       , Gg          , Gs^Fp       
Mm          , Hh          , Mm          , Hh          , Rd          , Rd          , Mm          , Ch          , Mm          , Ch          , Mm          , Mm          , Mm          , Mm          , Mm          , Hh          , Mm          , Ch          , Ch          , Ch          , Mm          , Gs^Fdf      , Xu          , Xu          , Xu          , Xu          , Xu          , Xu          , Xu          , Rd          , Rd          , Gg          , Gs^Fp       , Gs^Fdf      , Gs^Fmf      , Gg          , Gs^Fp       
Mm          , Mm          , Rd          , Rd          , Mm^Vhh      , Hh          , Mm          , Mm          , Mm          , Mm          , Mm          , Mm          , Mm          , Mm          , Mm          , Hh          , Hh          , Mm          , Mm          , Mm^Vhh      , Mm          , Gs^Fp       , Gs^Fdf      , Xu          , Gs^Fp       , Gs^Fdf      , Xu          , Gs^Fdf      , Gs^Fp       , Xu          , Gs^Fp       , Rd          , Rd          , Gs^Fdf      , Gs^Fmf      , Gs^Fdf      , Gs^Fdf      
Rd          , Hh          , Mm          , Mm          , Mm          , Mm          , Hh          , Mm          , Mm          , Mm          , Hh          , Mm          , Mm^Vhh      , Mm          , Mm          , Hh          , Mm          , Mm          , Mm          , Mm          , Gs^Fdf      , Gs^Fdf      , Gg^Vh       , Gs^Fdf      , Gs^Fmf      , Gs^Fdf      , Gs^Fmf      , Gs^Fdf      , Gs^Fmf      , Gs^Fdf      , Gs^Fmf      , Gg^Ve       , Gs^Fdf      , Rd          , Rd          , Gs^Fp       , Gs^Fp       
Re          , Rd          , Mm          , Hh          , Mm          , Hh          , Gs^Fp       , Mm          , Mm          , Hh          , Mm          , Hh          , Hh          , Mm          , Hh          , Hh          , Mm          , Mm          , Mm          , Mm          , Gs^Fp       , Gs^Fmf      , Gs^Fp       , Gs^Fp       , Gs^Fp       , Gs^Fmf      , Gs^Fp       , Gs^Fmf      , Gs^Fp       , Gs^Fmf      , Gs^Fp       , Gs^Fmf      , Gs^Fp       , Gs^Fp       , Gs^Fp       , Rd          , Rd          
