border_size=1
usage=map

Gs^Fp       , Gs^Fp       , Gs^Fp       , Gs^Fp       , Gs^Fp       , Gs^Fp       , Gs^Fp       , Gs^Fp       , Gs^Fp       , Rp          , Rp          , Gs^Fp       , Gs^Fp       , Gs^Fp       , Gs^Fp       , Gs^Fp       , Gs^Fp       , Gs^Fp       , Gs^Fp       , Gs^Fp       , Gs^Fp       , Gs^Fp       , Gs^Fp       , Gs^Fp       , Gs^Fp       , Gs^Fp       , Gs^Fp       , Gs^Fp       , Gs^Fp       , Gs^Fp       
Gs^Fp       , Gs^Fp       , Gs^Fp       , Gs^Fp       , Gs^Fp       , Gs^Fp       , Gs^Fmf      , Gs^Fp       , Gs^Fp       , Gg^Ve       , Gs^Fp       , Rp          , Rp          , Gs^Fp       , Gs^Fp       , Gs^Fp       , Ce          , Ke          , Ce          , Gs^Fp       , Gs^Fp       , Gs^Fp       , Gs^Fp       , Gs^Fp       , Gs^Fp       , Gs^Fp       , Gs^Fp       , Gs^Fp       , Gs^Fp       , Gs^Fp       
Gs^Fp       , Gs^Fp       , Gs^Fp       , Gs^Fp       , Gs^Fp       , Gs^Fp       , Gs^Fp       , Gs^Fmf      , Gs^Fmf      , Gs^Fp       , Gs^Fp       , Gs^Fp       , Gs^Fp       , Rp          , 2 Ce        , 3 Ce        , Gg          , Gg^Ve       , Gg^Wm       , Ce          , Ce          , Gs^Fp       , Gs^Fp       , Gs^Fp       , Gs^Fp       , Gs^Fp       , Gs^Fp       , Gs^Fp       , Gs^Fp       , Gs^Fp       
Rp          , Gs^Fp       , Rp          , Gg^Vh       , Rp          , Gs^Fp       , Gs^Fp       , Gg          , Gs^Fp       , Gs^Fp       , Gs^Fp       , Gs^Fp       , Ce          , 1 Ce        , Re^Gvs      , Re^Gvs      , Gg          , Gg          , Gs^Efm         , Re^Gvs      , Re^Gvs      , Ce          , Ce          , Gs^Fp       , Gs^Fp       , Gs^Fp       , Gs^Fp       , Gs^Fp       , Gs^Fp       , Gs^Fp       
Gs^Fp       , Rp          , Gs^Fp       , Rp          , Gs^Fp       , Rp          , Rp          , Gs^Fp       , Gs^Fp       , Gs^Fp       , Gs^Fp       , Ke          , Gg^Ve       , Gg^Wm       , Gg          , Gg          , Ch          , Ch          , Ch          , Gs^Efm         , Gs^Efm         , Gg          , Gg^Ve       , Ke          , Gs^Fp       , Gs^Fp       , Gs^Fp       , Gs^Fp       , Gs^Fp       , Gs^Fp       
Gs^Fp       , Gs^Fp       , Gs^Fp       , Gs^Fp       , Gs^Fp       , Gs^Fp       , Gs^Fp       , Rp          , Rp          , Gs^Fp       , Gs^Fp       , Ce          , Gg          , Gg          , Ch          , Ch          , Cv          , Kv          , Cv          , Ch          , Ch          , Gg          , Gg^Wm       , Ce          , Rp          , Gs^Fp       , Rp          , Gs^Fp       , Rp          , Gs^Fp       
Gs^Fp       , Gs^Fp       , Gs^Fp       , Gg          , Gs^Fmf      , Gs^Fmf      , Gs^Fp       , Gs^Fp       , Gg^Ve       , Rp          , Rp          , Ce          , Re^Gvs      , Gs^Efm         , Ch          , Kv          , Cv          , Cv          , Cv          , Kv          , Ch          , Gs^Efm         , Re^Gvs      , Ce          , Gs^Fp       , Rp          , Gs^Fp       , Rp          , Gg^Ve       , Rp          
Gs^Fp       , Gs^Fp       , Gs^Fp       , Gs^Fmf      , Gs^Fmf      , Gs^Fp       , Gs^Fp       , Gs^Fp       , Rp          , Rp          , Gs^Fmf      , Ce          , Re^Gvs      , Gs^Efm         , Ch          , Cv          , Cv          , 4 Kv        , Cv          , Cv          , Ch          , Gs^Efm         , Re^Gvs      , Ce          , Gs^Fp       , Gs^Fp       , Gs^Fp       , Gs^Fp       , Gs^Fp       , Gs^Fp       
Gs^Fp       , Gs^Fp       , Gs^Fp       , Gs^Fp       , Gs^Fp       , Gs^Fp       , Rp          , Rp          , Gs^Fp       , Gs^Fmf      , Gs^Fmf      , Ce          , Gg^Wm       , Gs^Efm         , Ch          , Kv          , Cv          , Cv          , Cv          , Kv          , Ch          , Gs^Efm         , Gg          , Ce          , Gs^Fp       , Gs^Fp       , Gs^Fp       , Gg          , Gs^Fp       , Gs^Fp       
Gs^Fp       , Gs^Fp       , Gs^Fp       , Gs^Fp       , Rp          , Rp          , Gs^Fp       , Gs^Fp       , Gs^Fp       , Gs^Fmf      , Gs^Fmf      , Ce          , Gg^Ve       , Gg          , Gs^Efm         , Ch          , Ch          , Kv          , Ch          , Ch          , Gs^Efm         , Gg          , Gg^Ve       , Ke          , Gs^Fp       , Gs^Fp       , Gs^Fp       , Gs^Fp       , Gs^Fp       , Gs^Fp       
Gs^Fp       , Gs^Fp       , Rp          , Rp          , Gs^Fp       , Gs^Fp       , Gs^Fp       , Gs^Fp       , Gg          , Gs^Fmf      , Gg          , Ke          , Ce          , Gg          , Re^Gvs      , Gs^Efm         , Gs^Efm         , Ch          , Gs^Efm         , Gs^Efm         , Re^Gvs      , Gg^Wm       , Ce          , Ce          , Gs^Fp       , Gg          , Gs^Fp       , Gs^Fp       , Gs^Fp       , Gs^Fp       
Rp          , Rp          , Gg^Ve       , Re          , Gs^Fp       , Gs^Fp       , Gg          , Gg          , Gs^Fp       , Gg          , Gs^Fmf      , Gs^Fmf      , Gs^Fmf      , Ce          , Ce          , Re^Gvs      , Gg^Wm       , Gg          , Gg          , Re^Gvs      , Ce          , Ce          , Gs^Fp       , Gs^Fp       , Gs^Fp       , Gs^Fp       , Gs^Fp       , Gs^Fp       , Gs^Fp       , Gs^Fp       
Gs^Fp       , Gs^Fp       , Gs^Fp       , Re          , Gs^Fp       , Gs^Fp       , Gs^Fp       , Gs^Fp       , Gs^Fp       , Gs^Fp       , Gs^Fp       , Gs^Fmf      , Gs^Fmf      , Gs^Fp       , Gs^Fp       , Ce          , Ce          , Gg^Ve       , Ce          , Ce          , Rr          , Gs^Fp       , Gs^Fp       , Gs^Fmw      , Gs^Fp       , Gs^Fp       , Gs^Fp       , Gs^Fp       , Gs^Fp       , Gs^Fp       
Gs^Fp       , Gs^Fp       , Gs^Fp       , Re          , Gs^Fp       , Gs^Fp       , Gs^Fp       , Gs^Fp       , Gs^Fp       , Gg          , Gg          , Gg^Vh       , Gs^Fp       , Gs^Fmf      , Gs^Fp       , Gs^Fp       , Gg          , Ke          , Gg          , Gs^Fp       , Gs^Fmf      , Rr          , Gs^Fmf      , Gs^Fmw      , Gs^Fmw      , Gs^Fp       , Gg^Vh       , Gs^Fp       , Gs^Fp       , Gs^Fp       
Gs^Fp       , Gs^Fp       , Gs^Fp       , Re          , Gs^Fp       , Gs^Fp       , Gs^Fp       , Gs^Fp       , Gs^Fp       , Gg          , Gg          , Gg          , Gs^Fp       , Gs^Fp       , Gg          , Gg          , Gg          , Gg          , Gs^Fp       , Gs^Fp       , Rr          , Rr          , Gs^Fp       , Gs^Fmw      , Gs^Fp       , Gs^Fp       , Gs^Fp       , Gs^Fp       , Gs^Fp       , Gs^Fp       
Gs^Fp       , Gs^Fp       , Gs^Fp       , Re          , Gs^Vht      , Gs^Fp       , Gs^Fp       , Gs^Fp       , Ww          , Ww          , Ww          , Ww          , Ww          , Gg          , Gg          , Gg          , Rp          , Gs^Fp       , Rp          , Rp          , Gs^Fp       , Gs^Fp       , Gs^Fp       , Gg          , Gs^Fp       , Gs^Fp       , Gs^Fp       , Gs^Fp       , Gs^Fp       , Gs^Fp       
Gs^Fp       , Gs^Fp       , Gs^Fp       , Re          , Re          , Gs^Fp       , Ww          , Ww          , Gs^Fp       , Gs^Fp       , Gs^Fp       , Gs^Fp       , Gs^Fp       , Ww          , Ww^Bw/      , Rp          , Gg^Ve       , Rp          , Gs^Fp       , Gs^Fp       , Gs^Fp       , Gs^Fp       , Gs^Fp       , Gs^Fp       , Gs^Fp       , Gs^Fmw      , Gs^Fmw      , Gs^Fp       , Gs^Fp       , Gs^Fp       
Wo          , Gs^Fp       , Gs^Fp       , Gs^Fp       , Wo          , Ww^Bw\      , Re          , Gs^Fp       , Gs^Fp       , Gs^Fp       , Hh^Fp       , Hh^Fp       , Hh^Fp       , Rp          , Gs^Fp       , Wwf         , Wwf         , Gs^Fp       , Gs^Fp       , Gs^Fp       , Gs^Fp       , Gs^Fp       , Gg          , Gs^Fp       , Gs^Fmw      , Gs^Fp       , Gs^Fmw      , Gs^Fmw      , Gs^Fp       , Gs^Fp       
Gs^Fp       , Wo          , Wo          , Wo          , Gs^Fp       , Gs^Fp       , Gs^Fp       , Re          , Hh          , Hh          , Hh          , Hh          , Hh^Fp       , Rp          , Rp          , Gs^Fp       , Gs^Fp       , Wwf         , Wwf         , Wwf         , Wwf         , Gs^Fp       , Hh          , Gs^Fp       , Gs^Fp       , Gs^Fp       , Gs^Fp       , Gs^Fmw      , Gs^Fp       , Gs^Fp       
Gs^Fp       , Gs^Fp       , Gs^Fp       , Gg          , Gs^Fp       , Gs^Fp       , Gs^Vht      , Re          , Hh          , Hh          , Mm          , Hh          , Hh^Fp       , Hh^Fp       , Rp          , Gg^Ve       , Gs^Fp       , Gs^Fp       , Hh          , Gs^Fp       , Hh          , Hh          , Mm          , Hh          , Hh          , Gs^Fp       , Gg^Vh       , Gs^Fp       , Gs^Fp       , Gs^Fp       
Gs^Fp       , Gg          , Gs^Fp       , Gs^Fp       , Gs^Fp       , Gs^Fp       , Gs^Fp       , Re          , Hh^Fmf      , Hh          , Hh          , Hh          , Gs^Fp       , Gs^Fp       , Gs^Fp       , Rp          , Rp          , Hh^Fp       , Hh^Fp       , Hh^Fp       , Hh^Fp       , Mm          , Mm          , Mm          , Hh          , Gs^Fp       , Gs^Fp       , Gs^Fp       , Gs^Fp       , Gs^Fp       
Re          , Gs^Fp       , Re          , Gs^Fp       , Re          , Re          , Re          , Re          , Gs^Fp       , Hh^Fmf      , Gs^Fp       , Gs^Fp       , Gs^Fp       , Gs^Fp       , Gs^Fp       , Gs^Fmf      , Gs^Fp       , Rp          , Rp          , Hh^Fp       , Hh^Fp       , Hh          , Hh          , Hh          , Hh          , Hh          , Hh^Fp       , Gs^Fp       , Gs^Fp       , Gs^Fp       
Gs^Fp       , Re          , Gs^Fp       , Re          , Gs^Fp       , Gs^Fp       , Gs^Fp       , Re          , Ce          , Ce          , Ce          , Gs^Fp       , Gs^Fp       , Gs^Fmf      , Gs^Fp       , Gs^Fp       , Ce          , Ce          , Ce          , Rp          , Gs^Fp       , Hh          , Hh          , Hh          , Gs^Fp       , Hh^Fp       , Gs^Fp       , Gs^Fp       , Gs^Fp       , Gs^Fp       
Gs^Fp       , Gs^Fp       , Gs^Fp       , Gs^Fp       , Gs^Fp       , Gs^Fp       , Gs^Fp       , Gs^Fp       , Ce          , 5 Ke        , Ce          , Ce          , Ce          , Gs^Fp       , Ce          , Ce          , Ce          , 6 Ke        , Ce          , Rp          , Gs^Fp       , Gs^Fp       , Gs^Fp       , Gs^Fp       , Gs^Fp       , Gs^Fp       , Gs^Fp       , Gs^Fp       , Gs^Fp       , Gs^Fp       
Gs^Fp       , Gs^Fp       , Gs^Fp       , Gs^Fp       , Gs^Fp       , Gs^Fp       , Gs^Fp       , Gs^Fp       , Gs^Fp       , Ce          , Gs^Fp       , Ce          , Gs^Fp       , Gs^Fp       , Gs^Fp       , Ce          , Gs^Fp       , Ce          , Gs^Fp       , Rp          , Gs^Fp       , Gs^Fp       , Gs^Fp       , Gs^Fp       , Gs^Fp       , Gs^Fp       , Gs^Fp       , Gs^Fp       , Gs^Fp       , Gs^Fp       
Gs^Fp       , Gs^Fp       , Gs^Fp       , Gs^Fp       , Gs^Fp       , Gs^Fp       , Gs^Fp       , Gs^Fp       , Gs^Fp       , Gs^Fp       , Gs^Fp       , Gs^Fp       , Gs^Fp       , Gs^Fp       , Gs^Fp       , Gs^Fp       , Gs^Fp       , Gs^Fp       , Gs^Fp       , Rp          , Gs^Fp       , Gs^Fp       , Gs^Fp       , Gs^Fp       , Gs^Fp       , Gs^Fp       , Gg          , Gs^Fp       , Gs^Fp       , Gs^Fp       
Gs^Fp       , Gs^Fp       , Gs^Fp       , Gs^Fp       , Gs^Fp       , Gs^Fp       , Gs^Fp       , Gs^Fp       , Gs^Fp       , Gs^Fp       , Gs^Fp       , Gs^Fmw      , Gs^Fp       , Gs^Fmw      , Gs^Fp       , Gs^Fp       , Gs^Fmw      , Gs^Fp       , Gs^Fp       , Rp          , Gs^Fp       , Gs^Fp       , Gs^Fp       , Gs^Fp       , Gs^Fp       , Gs^Fp       , Gs^Fp       , Gs^Fp       , Gs^Fp       , Gs^Fp       
Gg          , Gs^Fp       , Gs^Fp       , Gs^Fp       , Gs^Fp       , Gs^Fp       , Gs^Fp       , Gs^Fp       , Gs^Fp       , Gs^Fp       , Gg          , Gs^Fp       , Gs^Fp       , Gs^Fp       , Gg          , Gs^Fp       , Gs^Fp       , Gs^Fp       , Gs^Fp       , Rp          , Gs^Fp       , Gs^Fp       , Gs^Fp       , Gs^Fp       , Gs^Fp       , Gs^Fp       , Gg          , Gs^Fp       , Gs^Fp       , Gs^Fp       
Gg          , Gg          , Gs^Fp       , Gs^Fp       , Gs^Fp       , Gs^Fp       , Gs^Fp       , Gg          , Gg          , Gg          , Gg          , Gs^Fp       , Gs^Fp       , Gs^Fp       , Gs^Fp       , Gg          , Gg          , Gs^Fp       , Gs^Fp       , Rp          , Gs^Fp       , Gg          , Gg          , Gg          , Gg          , Gg          , Gg          , Gs^Fp       , Gs^Fp       , Gg          
